111111111111111111111
10CM00CM00C1C0000C001
10M000M00111111C11M01
100J0M000C000C000C001
10110C01110P000M01001
1C110100C011111100001
111101111011111C10M11
1C000M0M00C00000M00E1
111111111111111111111
