111111111111111111111111111111
1P0000000000000000000000000001
100100C100010C0100100000011001
10100111000111110001C000100001
100001000000000000011110000001
10010001C0000000000001C0100001
100100000001001001000100100001
10001000000000E000000000000001
100001000001001001001111000001
100011110000000000001C00001001
100000C00000010000001000001001
100011110011110000001000001001
100010000000000000001000111101
10000000C0000000000000000000J1
111111111111111111111111111111