1111111111111111
10000000001CCC11
10000000001110M1
100000P0000E0001
1000000000000001
1000000000000011
1C000000000000C1
1111111111111111

