111111111111111111111
100000CCC00000000C001
10C0000000000M0C00001
1000CC0000P0C0000C001
10000C00000C00000C001
10000C00C011111100001
111101111011111C00001
10000000000C0000000E1
111111111111111111111
