1111111111111111
1P00000000M00C01
100C00M0E011M001
10M0011000000011
100C010C00M010C1
1111111111111111
