1111111111111111
10P0000100M00C01
100C0000E1011M01
10M0011100000011
100C010C00M011C1
1111111111111111
