111111111111111111111
1ECMMMMMMMMMMMMMMMMM1
1MMMMMMMMMMMMMMMMMMM1
1MMMMMMMMMMMMMMMMMMM1
1MMMMMMMMMMMMMMMMMMM1
1MMMMMMMMMMMMMMMMMMM1
1MMMMMMMMMMMMMMMMMMM1
1MMMMMMMMMPMMMMMMMMM1
1MMMMMMMMMMMMMMMMMMM1
1MMMMMMMMMMMMMMMMMMM1
1MMMMMMMMMMMMMMMMMMM1
1MMMMMMMMMMMMMMMMMMM1
1MMMMMMMMMMMMMMMMMMM1
1MMMMMMMMMMMMMMMMMMM1
111111111111111111111
